000000000000000000 
0                0 
0                0 
0                0 
0                0 
0                0 
0                0 
0                0 
0                0 
0                0 
0                0 
0                0 
0                0 
0                0 
0                0 
0                0 
0                0 
0                0 
0                0 
0                0 
0                0 
0                0 
0    555         0 
0                0 
0                0 
0                0 
0                0 
0                0 
0                0 
0                0 
0                0 
0                0 
0                0 
0  555        5550 
0  0          0  0 
0  0          0  0 
0  0          0  0 
0  0          0  0 
0  0          0  0 
000000000000000000 